NO assets/bluestone.xpm
SO assets/eagle.xpm
WE assets/greystone.xpm
EA assets/redbrick.xpm
F 220,100,0
C 225,30,0

1111
1N 1
1111