NO textures/wall_1.xpm
SO textures/wall_2.xpm
WE textures/wall_3.xpm
EA textures/wall_4.xpm
F 100,100,100
C 200,200,200

11111111111111111111111111111111111111111111111111
10000000000000000000000000000000000000000000000001
10111111111111111111111111111111111111111111111101
10100000000000000000000000000000000000000000000101
10101111111111111111111111111111111111111111110101
10100000000000000000000000000000000000000000010101
10111111111111111111111111111111111111111111010101
10000000000000000000000000000000000000000001010101
11111111111111111111111111111111111111111101010101
10000000000000000000000000000000000000000101010101
10111111111111111111111111111111111111110101010101
10100000000000000000000000000000000000010101010101
10101111111111111111111111111111111111010101010101
10100000000000000000000000000000000001010101010101
10111111111111111111111111111111111101010101010101
10000000000000000000000000000000000101010101010101
11111111111111111111111111111111110101010101010101
10000000000000000000000000000000010101010101010101
10111111111111111111111111111111010101010101010101
10100000000000000000000000000001010101010101010101
10101111111111111111111111111 01010101010101010101
10100000000000000000000000000101010101010101010101
10111111111111111111111111110101010101010101010101
10000000000000000000000000010101010101010101010101
11111111111111111111111111010101010101010101010101
10000000000000000000000001010101010101010101010101
10111111111111111111111101010101010101010101010101
10100000000000000000000101010101010101010101010101
10101111111111111111110101010101010101010101010101
10100000000000000000010101010101010101010101010101
10111111111111111111010101010101010101010101010101
10000000000000000001010101010101010101010101010101
11111111111111111101010101010101010101010101010101
10000000000000000101010101010101010101010101010101
10111111111111110101010101010101010101010101010101
10100000000000010101010101010101010101010101010101
10101111111111010101010101010101010101010101010101
10100000000001010101010101010101010101010101010101
10111111111101010101010101010101010101010101010101
10000000001010101010101010101010101010101010101001
00111111010101010101010101010101010101010101010101
10000001010101010101010101010101010101010101010101
10111101010101010101010101010101010101010101010101
10101010101010101010101010101010101010101010101N01
10101010101010101010101010101010101010101010101101
10111111111111111111111111111111111111111111111101
10000000000000000000000000000000000000000000000001
11111111111111111111111111111111111111111111111111
