NO textures/wall_1.xpm
SO textures/wall_2.xpm
WE textures/wall_3.xpm
EA textures/wall_4.xpm

F 220,100,0
C 225,30,0

11111111111
10000000001
10000N00001
1000001
11111111111
