NO textures/wall_1.xpm
SO textures/wall_2.xpm
WE textures/wall_3.xpm
EA textures/wall_4.xpm
F 50,50,50
C 150,150,150

1111111111
1000000001
10111N1001
1000000001
1111111111
