NO textures/wall_1.xpm
SO textures/wall_2.xpm
WE textures/wall_3.xpm
EA textures/wall_4.xpm
F 100,100,100
C 200,200,200

1111
1 N1
1111
