NO textures/wall_1.xpm




WE  textures/wall_3.xpm    

             EA                    textures/wall_4.xpm

F 90,90,90
   SO textures/wall_2.xpm
C  0, 255,                                  0

1111111111111
1000000000001
100000N000001
10000001
1111111111111